1 5 5 5 5 5 5 5 5 5 5 5 5 5 5	 
2 5 5 5 5 5 5 5 5 5 5 5 5 5 5	 
1 4 4 4 4 4 0 0 0 0 0 4 4 4 4 	 
1 4 1 4 1 4 0 0 1 0 0 4 1 4 1	 
4 3 3 3 3 3 0 0 0 0 0 3 3 3 3	 
3 3 3 1 3 3 3 3 3 3 3 3 3 1 3	 
2 2 2 2 2 2 2 2 2 2 2 2 2 2 2	 
1 2 2 2 2 2 2 2 2 2 2 2 2 2 2	